################
#....#...#.....#
#.##.#.#...###.#
#.##.###...###.#
#.##...........#
#....##  ##....#
#....#R  G#....#
 ....#B  A#.... 
#....######....#
#..............#
#..###########.#
##.#...H.....#.#
#..#.#######...#
#.##........##.#
#....#....#....#
################
